Età,Popolazione,Prima,Due dosi,Seconda dose,Dose unica J&J,Dose guariti,Prima dose,Dose aggiuntiva/booster,Popolazione non vaccinata,Almeno una dose,Completa,Non vaccinati,aggiornamento,Regione,area,fascia,Aggiuntiva/booster
0-9 anni,4742049,0,0,0,0,0,0,0,4742049,0.0%,0.0%,100.0%,30/10/21,Italia,ITA,0-11,0.00%
10-19 anni,5673197,3339543,2958244,2959344,40013,104947,235239,1100,2333654,58.9%,54.7%,41.1%,30/10/21,Italia,ITA,12-19,0.02%
20-29 anni,6041667,5285096,4583274,4619592,124178,199376,341950,36318,756571,87.5%,81.8%,12.5%,30/10/21,Italia,ITA,20-29,0.60%
30-39 anni,6747378,5634110,4870922,4928548,142693,206241,356628,57626,1113268,83.5%,78.2%,16.5%,30/10/21,Italia,ITA,30-39,0.85%
40-49 anni,8700035,7287904,6371620,6455195,201004,285314,346391,83575,1412131,83.8%,79.8%,16.2%,30/10/21,Italia,ITA,40-49,0.96%
50-59 anni,9466362,8380912,7232824,7366648,377064,347719,289481,133824,1085450,88.5%,85.5%,11.5%,30/10/21,Italia,ITA,50-59,1.41%
60-69 anni,7441208,6783920,5780250,5960537,440893,241193,141297,180287,657288,91.2%,89.3%,8.8%,30/10/21,Italia,ITA,60-69,2.42%
70-79 anni,5965244,5562134,5012258,5164632,151495,165358,80649,152374,403110,93.2%,91.9%,6.8%,30/10/21,Italia,ITA,70-79,2.55%
80-89 anni,3665286,3531310,2644341,3391377,10220,77500,52213,747036,133976,96.3%,94.9%,3.7%,30/10/21,Italia,ITA,80-89,20.38%
oltre 90 anni,815140,816731,609329,769345,3826,18945,24615,160016,-1591,100.2%,97.2%,-0.2%,30/10/21,Italia,ITA,90+,19.63%
TOTALE,59257566,46621660,40063062,41615218,1491386,1646593,1868463,1552156,12635906,78.7%,75.5%,21.3%,30/10/21,TOTALE,ITA,TOTALE,2.62%
0-9 anni,827209,0,0,0,0,0,0,0,827209,0.0%,0.0%,100.0%,30/10/21,Lombardia,LOM,0-11,0.00%
10-19 anni,964465,617337,561279,561428,153,21335,34421,149,347128,64.0%,60.4%,36.0%,30/10/21,Lombardia,LOM,12-19,0.02%
20-29 anni,983209,943960,851625,859071,1705,38637,44547,7446,39249,96.0%,91.5%,4.0%,30/10/21,Lombardia,LOM,20-29,0.76%
30-39 anni,1145186,1029932,931497,942120,3376,40978,43458,10623,115254,89.9%,86.1%,10.1%,30/10/21,Lombardia,LOM,30-39,0.93%
40-49 anni,1504315,1307458,1185407,1200610,10485,55947,40416,15203,196857,86.9%,84.2%,13.1%,30/10/21,Lombardia,LOM,40-49,1.01%
50-59 anni,1609940,1473908,1189870,1213149,167339,64137,29283,23279,136032,91.6%,89.7%,8.4%,30/10/21,Lombardia,LOM,50-59,1.45%
60-69 anni,1201057,1113105,951596,974431,78600,46847,13227,22835,87952,92.7%,91.6%,7.3%,30/10/21,Lombardia,LOM,60-69,1.90%
70-79 anni,988111,929812,839449,856096,29893,33918,9905,16647,58299,94.1%,93.1%,5.9%,30/10/21,Lombardia,LOM,70-79,1.68%
80-89 anni,615067,607449,458927,588940,2124,12381,4004,130013,7618,98.8%,98.1%,1.2%,30/10/21,Lombardia,LOM,80-89,21.14%
oltre 90 anni,128433,135152,101917,129650,286,2159,3057,27733,-6719,105.2%,102.9%,-5.2%,30/10/21,Lombardia,LOM,90+,21.59%
0-9 anni,355686,0,0,0,0,0,0,0,355686,0.0%,0.0%,100.0%,30/10/21,Emilia-Romagna,EMR,0-11,0.00%
10-19 anni,411452,245923,217281,217368,1027,11080,16448,87,165529,59.8%,55.8%,40.2%,30/10/21,Emilia-Romagna,EMR,12-19,0.02%
20-29 anni,420475,390613,339143,340743,8944,17024,23902,1600,29862,92.9%,87.2%,7.1%,30/10/21,Emilia-Romagna,EMR,20-29,0.38%
30-39 anni,495231,426852,371023,374093,8425,17681,26653,3070,68379,86.2%,80.8%,13.8%,30/10/21,Emilia-Romagna,EMR,30-39,0.62%
40-49 anni,674865,564652,497560,502849,9582,25694,26527,5289,110213,83.7%,79.7%,16.3%,30/10/21,Emilia-Romagna,EMR,40-49,0.78%
50-59 anni,712475,633945,571239,579753,6761,28727,18704,8514,78530,89.0%,86.4%,11.0%,30/10/21,Emilia-Romagna,EMR,50-59,1.19%
60-69 anni,549321,501597,416283,426305,51336,16166,7790,10022,47724,91.3%,89.9%,8.7%,30/10/21,Emilia-Romagna,EMR,60-69,1.82%
70-79 anni,454505,425223,383477,392235,17029,11175,4784,8758,29282,93.6%,92.5%,6.4%,30/10/21,Emilia-Romagna,EMR,70-79,1.93%
80-89 anni,299028,293726,206219,282022,1127,6730,3847,75803,5302,98.2%,96.9%,1.8%,30/10/21,Emilia-Romagna,EMR,80-89,25.35%
oltre 90 anni,72511,76223,52434,71715,623,1810,2075,19281,-3712,105.1%,102.3%,-5.1%,30/10/21,Emilia-Romagna,EMR,90+,26.59%
0-9 anni,385892,0,0,0,0,0,0,0,385892,0.0%,0.0%,100.0%,30/10/21,Veneto,VEN,0-11,0.00%
10-19 anni,466296,261714,232767,232861,121,8591,20141,94,204582,56.1%,51.8%,43.9%,30/10/21,Veneto,VEN,12-19,0.02%
20-29 anni,481339,422147,370443,373758,663,16766,30960,3315,59192,87.7%,81.3%,12.3%,30/10/21,Veneto,VEN,20-29,0.69%
30-39 anni,524439,432278,377264,382311,903,16052,33012,5047,92161,82.4%,76.1%,17.6%,30/10/21,Veneto,VEN,30-39,0.96%
40-49 anni,717331,582002,516474,523772,1921,26961,29348,7298,135329,81.1%,77.0%,18.9%,30/10/21,Veneto,VEN,40-49,1.02%
50-59 anni,806474,696334,618109,629733,4119,37959,24523,11624,110140,86.3%,83.3%,13.7%,30/10/21,Veneto,VEN,50-59,1.44%
60-69 anni,610635,551471,453038,467064,48940,26712,8755,14026,59164,90.3%,88.9%,9.7%,30/10/21,Veneto,VEN,60-69,2.30%
70-79 anni,494721,462161,406046,419035,17831,19561,5734,12989,32560,93.4%,92.3%,6.6%,30/10/21,Veneto,VEN,70-79,2.63%
80-89 anni,298205,296512,241074,281370,1218,9530,4394,40296,1693,99.4%,98.0%,0.6%,30/10/21,Veneto,VEN,80-89,13.51%
oltre 90 anni,67121,70046,56934,64896,299,2739,2112,7962,-2925,104.4%,101.2%,-4.4%,30/10/21,Veneto,VEN,90+,11.86%
0-9 anni,322117,0,0,0,0,0,0,0,322117,0.0%,0.0%,100.0%,30/10/21,Piemonte,PIE,0-11,0.00%
10-19 anni,383188,217911,189908,190092,317,7287,20215,184,165277,56.9%,51.6%,43.1%,30/10/21,Piemonte,PIE,12-19,0.05%
20-29 anni,404501,364479,313536,316769,2599,13953,31158,3233,40022,90.1%,82.4%,9.9%,30/10/21,Piemonte,PIE,20-29,0.80%
30-39 anni,453297,376710,316040,321634,6995,15163,32918,5594,76587,83.1%,75.8%,16.9%,30/10/21,Piemonte,PIE,30-39,1.23%
40-49 anni,612180,498473,426036,435829,4917,21586,36141,9793,113707,81.4%,75.5%,18.6%,30/10/21,Piemonte,PIE,40-49,1.60%
50-59 anni,692135,601021,516357,533435,8430,26771,32385,17078,91114,86.8%,82.2%,13.2%,30/10/21,Piemonte,PIE,50-59,2.47%
60-69 anni,559966,495670,402982,424592,34957,20443,15678,21610,64296,88.5%,85.7%,11.5%,30/10/21,Piemonte,PIE,60-69,3.86%
70-79 anni,473035,435863,381050,400203,10146,15977,9537,19153,37172,92.1%,90.1%,7.9%,30/10/21,Piemonte,PIE,70-79,4.05%
80-89 anni,307031,298791,156019,283354,2372,7494,5571,127335,8240,97.3%,95.5%,2.7%,30/10/21,Piemonte,PIE,80-89,41.47%
oltre 90 anni,65760,68236,37158,62424,1904,1796,2112,25266,-2476,103.8%,100.6%,-3.8%,30/10/21,Piemonte,PIE,90+,38.42%
0-9 anni,87116,0,0,0,0,0,0,0,87116,0.0%,0.0%,100.0%,30/10/21,Friuli VG,FVG,0-11,0.00%
10-19 anni,105798,58074,51320,51323,12,2129,4610,3,47724,54.9%,50.5%,45.1%,30/10/21,Friuli VG,FVG,12-19,0.00%
20-29 anni,109577,101273,88496,89085,241,4825,7122,589,8304,92.4%,85.9%,7.6%,30/10/21,Friuli VG,FVG,20-29,0.54%
30-39 anni,123868,103235,89184,90024,299,4983,7929,840,20633,83.3%,76.9%,16.7%,30/10/21,Friuli VG,FVG,30-39,0.68%
40-49 anni,172496,136665,119448,120592,542,7794,7737,1144,35831,79.2%,74.7%,20.8%,30/10/21,Friuli VG,FVG,40-49,0.66%
50-59 anni,197534,165323,145346,147023,575,10202,7523,1677,32211,83.7%,79.9%,16.3%,30/10/21,Friuli VG,FVG,50-59,0.85%
60-69 anni,156447,134479,106132,108221,16465,6314,3479,2089,21968,86.0%,83.7%,14.0%,30/10/21,Friuli VG,FVG,60-69,1.34%
70-79 anni,140238,124000,109203,110838,5960,4986,2216,1635,16238,88.4%,86.8%,11.6%,30/10/21,Friuli VG,FVG,70-79,1.17%
80-89 anni,85322,82263,68761,79932,61,859,1411,11171,3059,96.4%,94.8%,3.6%,30/10/21,Friuli VG,FVG,80-89,13.09%
oltre 90 anni,20357,19875,17571,19145,3,176,551,1574,482,97.6%,94.9%,2.4%,30/10/21,Friuli VG,FVG,90+,7.73%
0-9 anni,9667,0,0,0,0,0,0,0,9667,0.0%,0.0%,100.0%,30/10/21,Valle d'Aosta,VDA,0-11,0.00%
10-19 anni,11812,6228,5425,5425,175,173,455,0,5584,52.7%,48.9%,47.3%,30/10/21,Valle d'Aosta,VDA,12-19,0.00%
20-29 anni,11940,9808,8541,8547,140,385,736,6,2132,82.1%,76.0%,17.9%,30/10/21,Valle d'Aosta,VDA,20-29,0.05%
30-39 anni,13010,10082,8761,8774,52,444,812,13,2928,77.5%,71.3%,22.5%,30/10/21,Valle d'Aosta,VDA,30-39,0.10%
40-49 anni,17884,13599,12060,12099,66,654,780,39,4285,76.0%,71.7%,24.0%,30/10/21,Valle d'Aosta,VDA,40-49,0.22%
50-59 anni,20922,17431,15750,15806,44,840,741,56,3491,83.3%,79.8%,16.7%,30/10/21,Valle d'Aosta,VDA,50-59,0.27%
60-69 anni,16123,13817,12288,12352,455,666,344,64,2306,85.7%,83.6%,14.3%,30/10/21,Valle d'Aosta,VDA,60-69,0.40%
70-79 anni,12953,11744,10835,10974,80,569,121,139,1209,90.7%,89.7%,9.3%,30/10/21,Valle d'Aosta,VDA,70-79,1.07%
80-89 anni,7803,7470,5599,7037,2,299,132,1438,333,95.7%,94.0%,4.3%,30/10/21,Valle d'Aosta,VDA,80-89,18.43%
oltre 90 anni,1781,1782,1276,1658,0,78,46,382,-1,100.1%,97.5%,-0.1%,30/10/21,Valle d'Aosta,VDA,90+,21.45%
0-9 anni,101299,0,0,0,0,0,0,0,101299,0.0%,0.0%,100.0%,30/10/21,Liguria,LIG,0-11,0.00%
10-19 anni,126067,67519,60071,60084,1982,1364,4089,13,58548,53.6%,50.3%,46.4%,30/10/21,Liguria,LIG,12-19,0.01%
20-29 anni,136820,119853,98570,98934,10910,2666,7343,364,16967,87.6%,82.2%,12.4%,30/10/21,Liguria,LIG,20-29,0.27%
30-39 anni,147115,121579,102640,103294,7380,2656,8249,654,25536,82.6%,77.0%,17.4%,30/10/21,Liguria,LIG,30-39,0.44%
40-49 anni,203007,162823,146745,147830,2613,3919,8461,1085,40184,80.2%,76.0%,19.8%,30/10/21,Liguria,LIG,40-49,0.53%
50-59 anni,253220,215236,198558,200630,946,5065,8595,2072,37984,85.0%,81.6%,15.0%,30/10/21,Liguria,LIG,50-59,0.82%
60-69 anni,203505,178689,160641,164331,6374,3382,4602,3690,24816,87.8%,85.5%,12.2%,30/10/21,Liguria,LIG,60-69,1.81%
70-79 anni,182496,164028,153508,157077,2144,2223,2584,3569,18468,89.9%,88.5%,10.1%,30/10/21,Liguria,LIG,70-79,1.96%
80-89 anni,125677,119926,97831,116234,141,1259,2292,18403,5751,95.4%,93.6%,4.6%,30/10/21,Liguria,LIG,80-89,14.64%
oltre 90 anni,30599,30469,24446,28852,163,309,1145,4406,130,99.6%,95.8%,0.4%,30/10/21,Liguria,LIG,90+,14.40%
0-9 anni,47826,0,0,0,0,0,0,0,47826,0.0%,0.0%,100.0%,30/10/21,Trento,PAT,0-11,0.00%
10-19 anni,55756,31626,27446,27449,8,1097,3072,3,24130,56.7%,51.2%,43.3%,30/10/21,Trento,PAT,12-19,0.01%
20-29 anni,58234,54771,45976,46162,29,2699,5881,186,3463,94.1%,84.0%,5.9%,30/10/21,Trento,PAT,20-29,0.32%
30-39 anni,61070,52179,43663,44018,44,2782,5335,355,8891,85.4%,76.7%,14.6%,30/10/21,Trento,PAT,30-39,0.58%
40-49 anni,76322,63211,52985,53546,1100,3829,4736,561,13111,82.8%,76.6%,17.2%,30/10/21,Trento,PAT,40-49,0.74%
50-59 anni,86000,75008,63751,64624,543,6165,3676,873,10992,87.2%,82.9%,12.8%,30/10/21,Trento,PAT,50-59,1.02%
60-69 anni,67987,61686,52824,53803,1822,4353,1708,979,6301,90.7%,88.2%,9.3%,30/10/21,Trento,PAT,60-69,1.44%
70-79 anni,52872,49737,44351,45279,524,2997,937,928,3135,94.1%,92.3%,5.9%,30/10/21,Trento,PAT,70-79,1.76%
80-89 anni,30673,30481,20284,28478,34,1397,572,8194,192,99.4%,97.5%,0.6%,30/10/21,Trento,PAT,80-89,26.71%
oltre 90 anni,8005,8277,5089,7679,7,341,250,2590,-272,103.4%,100.3%,-3.4%,30/10/21,Trento,PAT,90+,32.35%
0-9 anni,54481,0,0,0,0,0,0,0,54481,0.0%,0.0%,100.0%,30/10/21,Bolzano,PAB,0-11,0.00%
10-19 anni,57132,26313,21473,21490,287,1085,3451,17,30819,46.1%,40.0%,53.9%,30/10/21,Bolzano,PAB,12-19,0.03%
20-29 anni,61426,48178,39487,39682,2256,2426,3814,195,13248,78.4%,72.2%,21.6%,30/10/21,Bolzano,PAB,20-29,0.32%
30-39 anni,62922,48881,39648,40019,2808,2493,3561,371,14041,77.7%,72.0%,22.3%,30/10/21,Bolzano,PAB,30-39,0.59%
40-49 anni,74006,58866,49277,49985,1961,3578,3342,708,15140,79.5%,75.0%,20.5%,30/10/21,Bolzano,PAB,40-49,0.96%
50-59 anni,84510,70064,59379,60639,1307,4850,3268,1260,14446,82.9%,79.0%,17.1%,30/10/21,Bolzano,PAB,50-59,1.49%
60-69 anni,58814,51335,43099,44658,2270,3180,1227,1559,7479,87.3%,85.2%,12.7%,30/10/21,Bolzano,PAB,60-69,2.65%
70-79 anni,46424,40830,34981,36621,1376,2119,714,1640,5594,88.0%,86.4%,12.0%,30/10/21,Bolzano,PAB,70-79,3.53%
80-89 anni,27677,26184,18787,24039,530,1028,587,5252,1493,94.6%,92.5%,5.4%,30/10/21,Bolzano,PAB,80-89,18.98%
oltre 90 anni,6323,5973,4183,5283,100,320,270,1100,350,94.5%,90.2%,5.5%,30/10/21,Bolzano,PAB,90+,17.40%
0-9 anni,114169,0,0,0,0,0,0,0,114169,0.0%,0.0%,100.0%,30/10/21,Marche,MAR,0-11,0.00%
10-19 anni,137741,72822,65320,65331,28,2822,4641,11,64919,52.9%,49.5%,47.1%,30/10/21,Marche,MAR,12-19,0.01%
20-29 anni,145997,123356,110437,110779,358,5732,6487,342,22641,84.5%,80.0%,15.5%,30/10/21,Marche,MAR,20-29,0.23%
30-39 anni,163324,129657,115416,116115,493,5728,7321,699,33667,79.4%,74.9%,20.6%,30/10/21,Marche,MAR,30-39,0.43%
40-49 anni,218851,175407,158182,159346,1136,8004,6921,1164,43444,80.1%,77.0%,19.9%,30/10/21,Marche,MAR,40-49,0.53%
50-59 anni,236599,201894,182964,184941,1904,9326,5723,1977,34705,85.3%,82.9%,14.7%,30/10/21,Marche,MAR,50-59,0.84%
60-69 anni,194699,173304,144156,148141,17382,6209,1572,3985,21395,89.0%,88.2%,11.0%,30/10/21,Marche,MAR,60-69,2.05%
70-79 anni,156000,145960,131279,134921,6642,4146,251,3642,10040,93.6%,93.4%,6.4%,30/10/21,Marche,MAR,70-79,2.33%
80-89 anni,108153,102910,82018,98598,593,2545,1174,16580,5243,95.2%,94.1%,4.8%,30/10/21,Marche,MAR,80-89,15.33%
oltre 90 anni,25873,26049,21301,24432,119,872,626,3131,-176,100.7%,98.3%,-0.7%,30/10/21,Marche,MAR,90+,12.10%
0-9 anni,273053,0,0,0,0,0,0,0,273053,0.0%,0.0%,100.0%,30/10/21,Toscana,TOS,0-11,0.00%
10-19 anni,330958,207080,185016,185214,28,7453,14385,198,123878,62.6%,58.2%,37.4%,30/10/21,Toscana,TOS,12-19,0.06%
20-29 anni,338693,315176,274318,282030,436,12194,20516,7712,23517,93.1%,87.0%,6.9%,30/10/21,Toscana,TOS,20-29,2.28%
30-39 anni,395198,350870,306352,315769,540,12552,22009,9417,44328,88.8%,83.2%,11.2%,30/10/21,Toscana,TOS,30-39,2.38%
40-49 anni,540242,470989,417421,429703,755,17410,23121,12282,69253,87.2%,82.9%,12.8%,30/10/21,Toscana,TOS,40-49,2.27%
50-59 anni,590377,537498,479229,497134,1181,20059,19124,17905,52879,91.0%,87.8%,9.0%,30/10/21,Toscana,TOS,50-59,3.03%
60-69 anni,467270,429716,335315,353662,56773,11380,7901,18347,37554,92.0%,90.3%,8.0%,30/10/21,Toscana,TOS,60-69,3.93%
70-79 anni,406475,381612,337267,349368,19415,9910,2919,12101,24863,93.9%,93.2%,6.1%,30/10/21,Toscana,TOS,70-79,2.98%
80-89 anni,263150,261359,200973,251185,878,7536,1760,50212,1791,99.3%,98.7%,0.7%,30/10/21,Toscana,TOS,80-89,19.08%
oltre 90 anni,62917,66267,42142,62903,46,2028,1290,20761,-3350,105.3%,103.3%,-5.3%,30/10/21,Toscana,TOS,90+,33.00%
0-9 anni,463919,0,0,0,0,0,0,0,463919,0.0%,0.0%,100.0%,30/10/21,Lazio,LAZ,0-11,0.00%
10-19 anni,540535,310006,279519,279590,2851,8374,19191,71,230529,57.4%,53.8%,42.6%,30/10/21,Lazio,LAZ,12-19,0.01%
20-29 anni,558855,500762,412684,415040,42246,16219,27257,2356,58093,89.6%,84.7%,10.4%,30/10/21,Lazio,LAZ,20-29,0.42%
30-39 anni,665641,571380,470750,474979,53808,17694,24899,4229,94261,85.8%,82.1%,14.2%,30/10/21,Lazio,LAZ,30-39,0.64%
40-49 anni,879906,757274,617009,623152,79726,24879,29517,6143,122632,86.1%,82.7%,13.9%,30/10/21,Lazio,LAZ,40-49,0.70%
50-59 anni,940470,853189,700868,710010,89282,28661,25236,9142,87281,90.7%,88.0%,9.3%,30/10/21,Lazio,LAZ,50-59,0.97%
60-69 anni,707706,663804,590220,608474,22192,19895,13243,18254,43902,93.8%,91.9%,6.2%,30/10/21,Lazio,LAZ,60-69,2.58%
70-79 anni,551477,524036,475574,498672,5762,11903,7699,23098,27441,95.0%,93.6%,5.0%,30/10/21,Lazio,LAZ,70-79,4.19%
80-89 anni,338530,333113,240616,320959,297,5704,6153,80343,5417,98.4%,96.6%,1.6%,30/10/21,Lazio,LAZ,80-89,23.73%
oltre 90 anni,73757,74416,54023,70180,116,1566,2554,16157,-659,100.9%,97.4%,-0.9%,30/10/21,Lazio,LAZ,90+,21.91%
0-9 anni,64317,0,0,0,0,0,0,0,64317,0.0%,0.0%,100.0%,30/10/21,Umbria,UMB,0-11,0.00%
10-19 anni,78462,45375,39966,39994,15,1131,4235,28,33087,57.8%,52.4%,42.2%,30/10/21,Umbria,UMB,12-19,0.04%
20-29 anni,81178,67617,59640,60245,305,2226,4841,605,13561,83.3%,77.3%,16.7%,30/10/21,Umbria,UMB,20-29,0.75%
30-39 anni,95565,77246,67989,69285,199,2727,5035,1296,18319,80.8%,75.6%,19.2%,30/10/21,Umbria,UMB,30-39,1.36%
40-49 anni,124859,104724,93222,95069,108,4047,5500,1847,20135,83.9%,79.5%,16.1%,30/10/21,Umbria,UMB,40-49,1.48%
50-59 anni,135406,119683,108280,111075,84,4180,4344,2795,15723,88.4%,85.2%,11.6%,30/10/21,Umbria,UMB,50-59,2.06%
60-69 anni,111650,102812,77068,80883,17708,2302,1919,3815,8838,92.1%,90.4%,7.9%,30/10/21,Umbria,UMB,60-69,3.42%
70-79 anni,94797,90658,81347,84834,2464,1883,1477,3487,4139,95.6%,94.1%,4.4%,30/10/21,Umbria,UMB,70-79,3.68%
80-89 anni,63188,62695,37241,60453,41,1351,850,23212,493,99.2%,97.9%,0.8%,30/10/21,Umbria,UMB,80-89,36.73%
oltre 90 anni,15591,16664,12185,15787,10,384,483,3602,-1073,106.9%,103.8%,-6.9%,30/10/21,Umbria,UMB,90+,23.10%
0-9 anni,97834,0,0,0,0,0,0,0,97834,0.0%,0.0%,100.0%,30/10/21,Abruzzo,ABR,0-11,0.00%
10-19 anni,115344,69401,61968,61979,94,1906,5422,11,45943,60.2%,55.5%,39.8%,30/10/21,Abruzzo,ABR,12-19,0.01%
20-29 anni,128330,111658,99198,99761,1353,3882,6662,563,16672,87.0%,81.8%,13.0%,30/10/21,Abruzzo,ABR,20-29,0.44%
30-39 anni,148176,119546,104441,105653,2263,4107,7523,1212,28630,80.7%,75.6%,19.3%,30/10/21,Abruzzo,ABR,30-39,0.82%
40-49 anni,185634,153699,134747,136378,4865,5476,6980,1631,31935,82.8%,79.0%,17.2%,30/10/21,Abruzzo,ABR,40-49,0.88%
50-59 anni,204504,179156,156615,159012,7353,6387,6404,2397,25348,87.6%,84.5%,12.4%,30/10/21,Abruzzo,ABR,50-59,1.17%
60-69 anni,168878,153932,137190,140280,5706,4927,3019,3090,14946,91.1%,89.4%,8.9%,30/10/21,Abruzzo,ABR,60-69,1.83%
70-79 anni,131536,124222,115553,117429,2476,3199,1118,1876,7314,94.4%,93.6%,5.6%,30/10/21,Abruzzo,ABR,70-79,1.43%
80-89 anni,84626,79205,61775,76508,192,1842,663,14733,5421,93.6%,92.8%,6.4%,30/10/21,Abruzzo,ABR,80-89,17.41%
oltre 90 anni,20394,19402,14965,18519,53,560,270,3554,992,95.1%,93.8%,4.9%,30/10/21,Abruzzo,ABR,90+,17.43%
0-9 anni,20523,0,0,0,0,0,0,0,20523,0.0%,0.0%,100.0%,30/10/21,Molise,MOL,0-11,0.00%
10-19 anni,25234,16362,14622,14632,19,347,1364,10,8872,64.8%,59.4%,35.2%,30/10/21,Molise,MOL,12-19,0.04%
20-29 anni,31281,25837,21789,21896,1101,706,2134,107,5444,82.6%,75.8%,17.4%,30/10/21,Molise,MOL,20-29,0.34%
30-39 anni,33973,27417,22769,23025,1102,876,2414,256,6556,80.7%,73.6%,19.3%,30/10/21,Molise,MOL,30-39,0.75%
40-49 anni,41036,35558,31722,32135,616,1135,1672,413,5478,86.7%,82.6%,13.3%,30/10/21,Molise,MOL,40-49,1.01%
50-59 anni,46916,43644,38101,38904,1144,1764,1832,803,3272,93.0%,89.1%,7.0%,30/10/21,Molise,MOL,50-59,1.71%
60-69 anni,40784,38542,32873,35367,1483,1272,420,2494,2242,94.5%,93.5%,5.5%,30/10/21,Molise,MOL,60-69,6.12%
70-79 anni,30617,29379,25728,28181,542,712,-56,2453,1238,96.0%,96.1%,4.0%,30/10/21,Molise,MOL,70-79,8.01%
80-89 anni,20753,19905,6633,19005,27,478,395,12372,848,95.9%,94.0%,4.1%,30/10/21,Molise,MOL,80-89,59.62%
oltre 90 anni,5430,5488,2629,5032,3,210,243,2403,-58,101.1%,96.6%,-1.1%,30/10/21,Molise,MOL,90+,44.25%
0-9 anni,498552,0,0,0,0,0,0,0,498552,0.0%,0.0%,100.0%,30/10/21,Campania,CAM,0-11,0.00%
10-19 anni,616169,352134,295134,295224,20763,10492,25655,90,264035,57.1%,53.0%,42.9%,30/10/21,Campania,CAM,12-19,0.01%
20-29 anni,685126,562372,470716,473834,23792,23548,41198,3118,122754,82.1%,76.1%,17.9%,30/10/21,Campania,CAM,20-29,0.46%
30-39 anni,706752,567340,471526,477189,24390,23837,41924,5663,139412,80.3%,74.3%,19.7%,30/10/21,Campania,CAM,30-39,0.80%
40-49 anni,819391,682726,591353,598809,18062,28702,37153,7456,136665,83.3%,78.8%,16.7%,30/10/21,Campania,CAM,40-49,0.91%
50-59 anni,871123,766911,674010,688103,12359,38763,27686,14093,104212,88.0%,84.9%,12.0%,30/10/21,Campania,CAM,50-59,1.62%
60-69 anni,681008,622132,538693,562591,13869,27069,18603,23898,58876,91.4%,88.6%,8.6%,30/10/21,Campania,CAM,60-69,3.51%
70-79 anni,491191,454430,406538,425681,2535,16108,10106,19143,36761,92.5%,90.5%,7.5%,30/10/21,Campania,CAM,70-79,3.90%
80-89 anni,258456,235248,163266,224988,96,6128,4036,61722,23208,91.0%,89.5%,9.0%,30/10/21,Campania,CAM,80-89,23.88%
oltre 90 anni,51991,45100,34098,42543,6,932,1619,8445,6891,86.7%,83.6%,13.3%,30/10/21,Campania,CAM,90+,16.24%
0-9 anni,307917,0,0,0,0,0,0,0,307917,0.0%,0.0%,100.0%,30/10/21,Puglia,PUG,0-11,0.00%
10-19 anni,389429,251560,226986,227054,919,8264,15323,68,137869,64.6%,60.7%,35.4%,30/10/21,Puglia,PUG,12-19,0.02%
20-29 anni,435687,366319,320986,323305,4810,15122,23082,2319,69368,84.1%,78.8%,15.9%,30/10/21,Puglia,PUG,20-29,0.53%
30-39 anni,453251,381476,331329,335193,6627,15706,23950,3864,71775,84.2%,78.9%,15.8%,30/10/21,Puglia,PUG,30-39,0.85%
40-49 anni,570896,499862,430746,435965,21787,20624,21486,5219,71034,87.6%,83.8%,12.4%,30/10/21,Puglia,PUG,40-49,0.91%
50-59 anni,607181,559999,475384,483192,32934,24624,19249,7808,47182,92.2%,89.1%,7.8%,30/10/21,Puglia,PUG,50-59,1.29%
60-69 anni,494337,472822,407207,417154,26502,18903,10263,9947,21515,95.6%,93.6%,4.4%,30/10/21,Puglia,PUG,60-69,2.01%
70-79 anni,395276,385214,347090,353118,13597,11591,6908,6028,10062,97.5%,95.7%,2.5%,30/10/21,Puglia,PUG,70-79,1.53%
80-89 anni,224826,220353,180110,210944,136,4650,4623,30834,4473,98.0%,96.0%,2.0%,30/10/21,Puglia,PUG,80-89,13.71%
oltre 90 anni,48131,48982,41647,46136,5,992,1849,4489,-851,101.8%,97.9%,-1.8%,30/10/21,Puglia,PUG,90+,9.33%
0-9 anni,39386,0,0,0,0,0,0,0,39386,0.0%,0.0%,100.0%,30/10/21,Basilicata,BAS,0-11,0.00%
10-19 anni,50240,31877,27448,27453,1579,818,2027,5,18363,63.4%,59.4%,36.6%,30/10/21,Basilicata,BAS,12-19,0.01%
20-29 anni,59650,47531,42299,42397,884,1532,2718,98,12119,79.7%,75.1%,20.3%,30/10/21,Basilicata,BAS,20-29,0.16%
30-39 anni,64519,49842,44612,44788,609,1434,3011,176,14677,77.3%,72.6%,22.7%,30/10/21,Basilicata,BAS,30-39,0.27%
40-49 anni,76260,63888,56221,56548,2848,1843,2649,327,12372,83.8%,80.3%,16.2%,30/10/21,Basilicata,BAS,40-49,0.43%
50-59 anni,87305,78227,69593,70050,3023,2394,2760,457,9078,89.6%,86.4%,10.4%,30/10/21,Basilicata,BAS,50-59,0.52%
60-69 anni,73674,69192,62846,63756,2097,1627,1712,910,4482,93.9%,91.6%,6.1%,30/10/21,Basilicata,BAS,60-69,1.24%
70-79 anni,52557,50438,48039,48443,134,999,862,404,2119,96.0%,94.3%,4.0%,30/10/21,Basilicata,BAS,70-79,0.77%
80-89 anni,35786,33498,28485,32338,5,522,633,3853,2288,93.6%,91.8%,6.4%,30/10/21,Basilicata,BAS,80-89,10.77%
oltre 90 anni,8202,8172,7007,7723,1,144,304,716,30,99.6%,95.9%,0.4%,30/10/21,Basilicata,BAS,90+,8.73%
0-9 anni,154451,0,0,0,0,0,0,0,154451,0.0%,0.0%,100.0%,30/10/21,Calabria,CAL,0-11,0.00%
10-19 anni,181488,98497,88886,88895,588,1698,7316,9,82991,54.3%,50.2%,45.7%,30/10/21,Calabria,CAL,12-19,0.00%
20-29 anni,208920,160730,141014,141298,5461,3418,10553,284,48190,76.9%,71.9%,23.1%,30/10/21,Calabria,CAL,20-29,0.14%
30-39 anni,232935,170847,147950,148447,7067,3330,12003,497,62088,73.3%,68.2%,26.7%,30/10/21,Calabria,CAL,30-39,0.21%
40-49 anni,261369,206066,175846,176575,14832,3899,10760,729,55303,78.8%,74.7%,21.2%,30/10/21,Calabria,CAL,40-49,0.28%
50-59 anni,284757,236642,206126,207523,15215,4211,9693,1397,48115,83.1%,79.7%,16.9%,30/10/21,Calabria,CAL,50-59,0.49%
60-69 anni,243667,214347,197456,200399,6783,2958,4207,2943,29320,88.0%,86.2%,12.0%,30/10/21,Calabria,CAL,60-69,1.21%
70-79 anni,177666,160171,152319,154651,2185,1587,1748,2332,17495,90.2%,89.2%,9.8%,30/10/21,Calabria,CAL,70-79,1.31%
80-89 anni,108240,93476,85226,90937,75,684,1780,5711,14764,86.4%,84.7%,13.6%,30/10/21,Calabria,CAL,80-89,5.28%
oltre 90 anni,24235,20225,18191,19254,17,134,820,1063,4010,83.5%,80.1%,16.5%,30/10/21,Calabria,CAL,90+,4.39%
0-9 anni,411065,0,0,0,0,0,0,0,411065,0.0%,0.0%,100.0%,30/10/21,Sicilia,SIC,0-11,0.00%
10-19 anni,491263,264535,226591,226626,9044,5963,22902,35,226728,53.8%,49.2%,46.2%,30/10/21,Sicilia,SIC,12-19,0.01%
20-29 anni,551159,424492,360688,361906,15850,12176,34560,1218,126667,77.0%,70.7%,23.0%,30/10/21,Sicilia,SIC,20-29,0.22%
30-39 anni,581042,441369,376127,378200,15024,11498,36647,2073,139673,76.0%,69.7%,24.0%,30/10/21,Sicilia,SIC,30-39,0.36%
40-49 anni,684564,546020,471942,474792,22555,14269,34404,2850,138544,79.8%,74.7%,20.2%,30/10/21,Sicilia,SIC,40-49,0.42%
50-59 anni,732410,621761,547745,552597,21685,16902,30577,4852,110649,84.9%,80.7%,15.1%,30/10/21,Sicilia,SIC,50-59,0.66%
60-69 anni,608346,534491,479319,489897,15255,12210,17129,10578,73855,87.9%,85.0%,12.1%,30/10/21,Sicilia,SIC,60-69,1.74%
70-79 anni,460198,411469,380931,389561,4896,7132,9880,8630,48729,89.4%,87.3%,10.6%,30/10/21,Sicilia,SIC,70-79,1.88%
80-89 anni,265138,234123,207162,224713,110,3706,5594,17551,31015,88.3%,86.2%,11.7%,30/10/21,Sicilia,SIC,80-89,6.62%
oltre 90 anni,55691,49185,43061,46056,16,969,2144,2995,6506,88.3%,84.5%,11.7%,30/10/21,Sicilia,SIC,90+,5.38%
0-9 anni,105570,0,0,0,0,0,0,0,105570,0.0%,0.0%,100.0%,30/10/21,Sardegna,SAR,0-11,0.00%
10-19 anni,134368,87249,79818,79832,3,1538,5876,14,47119,64.9%,60.6%,35.1%,30/10/21,Sardegna,SAR,12-19,0.01%
20-29 anni,149270,124164,113688,114350,95,3240,6479,662,25106,83.2%,78.8%,16.8%,30/10/21,Sardegna,SAR,20-29,0.44%
30-39 anni,180864,145392,131941,133618,289,3520,7965,1677,35472,80.4%,76.0%,19.6%,30/10/21,Sardegna,SAR,30-39,0.93%
40-49 anni,244621,203942,187217,189611,527,5064,8740,2394,40679,83.4%,79.8%,16.6%,30/10/21,Sardegna,SAR,40-49,0.98%
50-59 anni,266104,234038,215550,219315,836,5732,8155,3765,32066,87.9%,84.9%,12.1%,30/10/21,Sardegna,SAR,50-59,1.41%
60-69 anni,225334,206977,179024,184176,13924,4378,4499,5152,18357,91.9%,89.9%,8.1%,30/10/21,Sardegna,SAR,60-69,2.29%
70-79 anni,172099,161147,147693,151415,5864,2663,1205,3722,10952,93.6%,92.9%,6.4%,30/10/21,Sardegna,SAR,70-79,2.16%
80-89 anni,97957,92623,77335,89343,161,1377,1742,12008,5334,94.6%,92.8%,5.4%,30/10/21,Sardegna,SAR,80-89,12.26%
oltre 90 anni,22038,20748,17072,19478,49,426,795,2406,1290,94.1%,90.5%,5.9%,30/10/21,Sardegna,SAR,90+,10.92%
