Età,Popolazione,Prima,Due dosi,Seconda dose,Dose unica J&J,Dose guariti,Prima dose,Dose aggiuntiva,Popolazione non vaccinata,Almeno una dose,Completa,Non vaccinati,aggiornamento,Regione,area,fascia,Aggiuntiva
0-9 anni,4742049,0,0,0,0,0,0,0,4742049,0.0%,0.0%,100.0%,08/10/21,Italia,ITA,0-11,0.00%
10-19 anni,5673197,3220769,2742759,2743189,39861,94900,342819,430,2452428,56.8%,50.7%,43.2%,08/10/21,Italia,ITA,12-19,0.01%
20-29 anni,6041667,5102750,4335545,4339069,122206,185257,456218,3524,938917,84.5%,76.9%,15.5%,08/10/21,Italia,ITA,20-29,0.06%
30-39 anni,6747378,5419851,4585974,4592813,140038,191166,495834,6839,1327527,80.3%,73.0%,19.7%,08/10/21,Italia,ITA,30-39,0.10%
40-49 anni,8700035,7088612,6126421,6141081,198769,266767,481995,14660,1611423,81.5%,75.9%,18.5%,08/10/21,Italia,ITA,40-49,0.17%
50-59 anni,9466362,8219857,7093834,7122125,375410,331165,391157,28291,1246505,86.8%,82.7%,13.2%,08/10/21,Italia,ITA,50-59,0.30%
60-69 anni,7441208,6715233,5822494,5861035,438836,234303,181059,38541,725975,90.2%,87.8%,9.8%,08/10/21,Italia,ITA,60-69,0.52%
70-79 anni,5965244,5536342,5079645,5119069,150956,164508,101809,39424,428902,92.8%,91.1%,7.2%,08/10/21,Italia,ITA,70-79,0.66%
80-89 anni,3665286,3519690,3263761,3367595,10125,80556,61414,103834,145596,96.0%,94.4%,4.0%,08/10/21,Italia,ITA,80-89,2.83%
oltre 90 anni,815140,813766,743478,762763,3802,20264,26937,19285,1374,99.8%,96.5%,0.2%,08/10/21,Italia,ITA,90+,2.37%
TOTALE,59257566,45636870,39793911,40048739,1480003,1568886,2539242,254828,13620696,77.0%,72.7%,23.0%,08/10/21,TOTALE,ITA,TOTALE,0.43%
0-9 anni,827209,0,0,0,0,0,0,0,827209,0.0%,0.0%,100.0%,08/10/21,Lombardia,LOM,0-11,0.00%
10-19 anni,964465,599231,530933,530970,152,19699,48410,37,365234,62.1%,57.1%,37.9%,08/10/21,Lombardia,LOM,12-19,0.00%
20-29 anni,983209,921890,815677,815934,1685,36500,67771,257,61319,93.8%,86.9%,6.2%,08/10/21,Lombardia,LOM,20-29,0.03%
30-39 anni,1145186,1003829,891174,891749,3339,38324,70417,575,141357,87.7%,81.5%,12.3%,08/10/21,Lombardia,LOM,30-39,0.05%
40-49 anni,1504315,1283252,1150570,1152098,10445,52404,68305,1528,221063,85.3%,80.8%,14.7%,08/10/21,Lombardia,LOM,40-49,0.10%
50-59 anni,1609940,1454821,1173187,1176522,167299,61057,49943,3335,155119,90.4%,87.3%,9.6%,08/10/21,Lombardia,LOM,50-59,0.21%
60-69 anni,1201057,1105422,957616,961750,78394,45517,19761,4134,95635,92.0%,90.4%,8.0%,08/10/21,Lombardia,LOM,60-69,0.34%
70-79 anni,988111,926870,846656,850767,29841,33394,12868,4111,61241,93.8%,92.5%,6.2%,08/10/21,Lombardia,LOM,70-79,0.42%
80-89 anni,615067,605914,570999,586183,2117,11786,5828,15184,9153,98.5%,97.6%,1.5%,08/10/21,Lombardia,LOM,80-89,2.47%
oltre 90 anni,128433,134750,125689,128969,282,2019,3480,3280,-6317,104.9%,102.2%,-4.9%,08/10/21,Lombardia,LOM,90+,2.55%
0-9 anni,355686,0,0,0,0,0,0,0,355686,0.0%,0.0%,100.0%,08/10/21,Emilia-Romagna,EMR,0-11,0.00%
10-19 anni,411452,237705,204070,204107,1007,10237,22354,37,173747,57.8%,52.3%,42.2%,08/10/21,Emilia-Romagna,EMR,12-19,0.01%
20-29 anni,420475,377044,316473,316650,8849,15989,35556,177,43431,89.7%,81.2%,10.3%,08/10/21,Emilia-Romagna,EMR,20-29,0.04%
30-39 anni,495231,411013,344695,345083,8312,16629,40989,388,84218,83.0%,74.7%,17.0%,08/10/21,Emilia-Romagna,EMR,30-39,0.08%
40-49 anni,674865,549300,474547,475548,9460,24371,39921,1001,125565,81.4%,75.5%,18.6%,08/10/21,Emilia-Romagna,EMR,40-49,0.15%
50-59 anni,712475,622655,559413,561395,6639,27611,27010,1982,89820,87.4%,83.6%,12.6%,08/10/21,Emilia-Romagna,EMR,50-59,0.28%
60-69 anni,549321,497094,417950,420571,50822,15804,9897,2621,52227,90.5%,88.7%,9.5%,08/10/21,Emilia-Romagna,EMR,60-69,0.48%
70-79 anni,454505,423801,387201,389969,16888,11256,5688,2768,30704,93.2%,92.0%,6.8%,08/10/21,Emilia-Romagna,EMR,70-79,0.61%
80-89 anni,299028,293137,279347,280655,1118,7257,4107,1308,5891,98.0%,96.7%,2.0%,08/10/21,Emilia-Romagna,EMR,80-89,0.44%
oltre 90 anni,72511,76070,71236,71365,620,1904,2181,129,-3559,104.9%,101.9%,-4.9%,08/10/21,Emilia-Romagna,EMR,90+,0.18%
0-9 anni,385892,0,0,0,0,0,0,0,385892,0.0%,0.0%,100.0%,08/10/21,Veneto,VEN,0-11,0.00%
10-19 anni,466296,252604,218522,218583,122,7906,25993,61,213692,54.2%,48.6%,45.8%,08/10/21,Veneto,VEN,12-19,0.01%
20-29 anni,481339,407510,348523,348933,662,16005,41910,410,73829,84.7%,76.0%,15.3%,08/10/21,Veneto,VEN,20-29,0.09%
30-39 anni,524439,415219,351677,352335,902,15345,46637,658,109220,79.2%,70.3%,20.8%,08/10/21,Veneto,VEN,30-39,0.13%
40-49 anni,717331,566029,494369,495827,1916,25967,42319,1458,151302,78.9%,73.0%,21.1%,08/10/21,Veneto,VEN,40-49,0.20%
50-59 anni,806474,683856,605233,607912,4111,37075,34758,2679,122618,84.8%,80.5%,15.2%,08/10/21,Veneto,VEN,50-59,0.33%
60-69 anni,610635,547224,457180,460817,48734,26675,10998,3637,63411,89.6%,87.8%,10.4%,08/10/21,Veneto,VEN,60-69,0.60%
70-79 anni,494721,460888,412244,416001,17785,20266,6836,3757,33833,93.2%,91.8%,6.8%,08/10/21,Veneto,VEN,70-79,0.76%
80-89 anni,298205,296082,272741,279340,1211,10670,4861,6599,2123,99.3%,97.7%,0.7%,08/10/21,Veneto,VEN,80-89,2.21%
oltre 90 anni,67121,69915,62724,64187,297,3211,2220,1463,-2794,104.2%,100.9%,-4.2%,08/10/21,Veneto,VEN,90+,2.18%
0-9 anni,322117,0,0,0,0,0,0,0,322117,0.0%,0.0%,100.0%,08/10/21,Piemonte,PIE,0-11,0.00%
10-19 anni,383188,207382,167646,167726,312,6384,32960,80,175806,54.1%,45.5%,45.9%,08/10/21,Piemonte,PIE,12-19,0.02%
20-29 anni,404501,348228,290626,291107,2506,12916,41699,481,56273,86.1%,75.8%,13.9%,08/10/21,Piemonte,PIE,20-29,0.12%
30-39 anni,453297,358277,291659,292561,6900,14023,44793,902,95020,79.0%,69.2%,21.0%,08/10/21,Piemonte,PIE,30-39,0.20%
40-49 anni,612180,479980,404387,406806,4794,20105,48275,2419,132200,78.4%,70.5%,21.6%,08/10/21,Piemonte,PIE,40-49,0.40%
50-59 anni,692135,585641,504760,509990,8313,25545,41793,5230,106494,84.6%,78.6%,15.4%,08/10/21,Piemonte,PIE,50-59,0.76%
60-69 anni,559966,489484,408341,416370,34739,19957,18418,8029,70482,87.4%,84.1%,12.6%,08/10/21,Piemonte,PIE,60-69,1.43%
70-79 anni,473035,433456,386688,396520,10085,16069,10782,9832,39579,91.6%,89.4%,8.4%,08/10/21,Piemonte,PIE,70-79,2.08%
80-89 anni,307031,297693,265587,280822,2358,8196,6317,15235,9338,97.0%,94.9%,3.0%,08/10/21,Piemonte,PIE,80-89,4.96%
oltre 90 anni,65760,67988,58212,61554,1900,2173,2361,3342,-2228,103.4%,99.8%,-3.4%,08/10/21,Piemonte,PIE,90+,5.08%
0-9 anni,87116,0,0,0,0,0,0,0,87116,0.0%,0.0%,100.0%,08/10/21,Friuli VG,FVG,0-11,0.00%
10-19 anni,105798,55246,46463,46466,8,2022,6750,3,50552,52.2%,45.8%,47.8%,08/10/21,Friuli VG,FVG,12-19,0.00%
20-29 anni,109577,96443,81590,81619,157,4667,10000,29,13134,88.0%,78.9%,12.0%,08/10/21,Friuli VG,FVG,20-29,0.03%
30-39 anni,123868,97564,81457,81514,237,4821,10992,57,26304,78.8%,69.9%,21.2%,08/10/21,Friuli VG,FVG,30-39,0.05%
40-49 anni,172496,131183,112135,112290,496,7557,10840,155,41313,76.0%,69.8%,24.0%,08/10/21,Friuli VG,FVG,40-49,0.09%
50-59 anni,197534,160282,139750,140013,540,10004,9725,263,37252,81.1%,76.2%,18.9%,08/10/21,Friuli VG,FVG,50-59,0.13%
60-69 anni,156447,132607,105034,105443,16436,6240,4488,409,23840,84.8%,81.9%,15.2%,08/10/21,Friuli VG,FVG,60-69,0.26%
70-79 anni,140238,123189,109335,109739,5955,4969,2526,404,17049,87.8%,86.0%,12.2%,08/10/21,Friuli VG,FVG,70-79,0.29%
80-89 anni,85322,81605,78150,79221,61,908,1415,1071,3717,95.6%,94.0%,4.4%,08/10/21,Friuli VG,FVG,80-89,1.26%
oltre 90 anni,20357,19727,18860,18980,2,183,562,120,630,96.9%,94.1%,3.1%,08/10/21,Friuli VG,FVG,90+,0.59%
0-9 anni,9667,0,0,0,0,0,0,0,9667,0.0%,0.0%,100.0%,08/10/21,Valle d'Aosta,VDA,0-11,0.00%
10-19 anni,11812,5967,5039,5039,175,154,599,0,5845,50.5%,45.4%,49.5%,08/10/21,Valle d'Aosta,VDA,12-19,0.00%
20-29 anni,11940,9347,8064,8064,140,342,801,0,2593,78.3%,71.6%,21.7%,08/10/21,Valle d'Aosta,VDA,20-29,0.00%
30-39 anni,13010,9580,8208,8209,52,387,932,1,3430,73.6%,66.5%,26.4%,08/10/21,Valle d'Aosta,VDA,30-39,0.01%
40-49 anni,17884,13100,11608,11608,66,566,860,0,4784,73.2%,68.4%,26.8%,08/10/21,Valle d'Aosta,VDA,40-49,0.00%
50-59 anni,20922,17020,15409,15409,44,767,800,0,3902,81.3%,77.5%,18.7%,08/10/21,Valle d'Aosta,VDA,50-59,0.00%
60-69 anni,16123,13632,12173,12173,455,633,371,0,2491,84.6%,82.2%,15.4%,08/10/21,Valle d'Aosta,VDA,60-69,0.00%
70-79 anni,12953,11679,10912,10912,80,554,133,0,1274,90.2%,89.1%,9.8%,08/10/21,Valle d'Aosta,VDA,70-79,0.00%
80-89 anni,7803,7448,6999,6999,2,309,138,0,355,95.5%,93.7%,4.5%,08/10/21,Valle d'Aosta,VDA,80-89,0.00%
oltre 90 anni,1781,1779,1654,1654,0,76,49,0,2,99.9%,97.1%,0.1%,08/10/21,Valle d'Aosta,VDA,90+,0.00%
0-9 anni,101299,0,0,0,0,0,0,0,101299,0.0%,0.0%,100.0%,08/10/21,Liguria,LIG,0-11,0.00%
10-19 anni,126067,64280,54809,54809,1982,1149,6340,0,61787,51.0%,46.0%,49.0%,08/10/21,Liguria,LIG,12-19,0.00%
20-29 anni,136820,114723,91045,91056,10885,2320,10462,11,22097,83.8%,76.2%,16.2%,08/10/21,Liguria,LIG,20-29,0.01%
30-39 anni,147115,115852,94596,94647,7362,2341,11502,51,31263,78.7%,70.9%,21.3%,08/10/21,Liguria,LIG,30-39,0.03%
40-49 anni,203007,157166,139389,139474,2596,3441,11655,85,45841,77.4%,71.7%,22.6%,08/10/21,Liguria,LIG,40-49,0.04%
50-59 anni,253220,210031,193234,193395,936,4498,11202,161,43189,82.9%,78.5%,17.1%,08/10/21,Liguria,LIG,50-59,0.06%
60-69 anni,203505,176388,160762,160994,6371,3134,5889,232,27117,86.7%,83.8%,13.3%,08/10/21,Liguria,LIG,60-69,0.11%
70-79 anni,182496,163174,155460,155774,2143,2090,3167,314,19322,89.4%,87.7%,10.6%,08/10/21,Liguria,LIG,70-79,0.17%
80-89 anni,125677,119449,112687,115637,141,1262,2409,2950,6228,95.0%,93.1%,5.0%,08/10/21,Liguria,LIG,80-89,2.35%
oltre 90 anni,30599,30319,27915,28687,163,310,1159,772,280,99.1%,95.3%,0.9%,08/10/21,Liguria,LIG,90+,2.52%
0-9 anni,47826,0,0,0,0,0,0,0,47826,0.0%,0.0%,100.0%,08/10/21,Trento,PAT,0-11,0.00%
10-19 anni,55756,30305,25325,25327,3,1004,3971,2,25451,54.4%,47.2%,45.6%,08/10/21,Trento,PAT,12-19,0.00%
20-29 anni,58234,52569,42548,42576,15,2559,7419,28,5665,90.3%,77.5%,9.7%,08/10/21,Trento,PAT,20-29,0.05%
30-39 anni,61070,49718,40012,40051,29,2659,6979,39,11352,81.4%,70.0%,18.6%,08/10/21,Trento,PAT,30-39,0.06%
40-49 anni,76322,61033,49803,49880,1085,3697,6371,77,15289,80.0%,71.6%,20.0%,08/10/21,Trento,PAT,40-49,0.10%
50-59 anni,86000,73331,61871,62027,522,6036,4746,156,12669,85.3%,79.8%,14.7%,08/10/21,Trento,PAT,50-59,0.18%
60-69 anni,67987,60960,52638,52857,1778,4306,2019,219,7027,89.7%,86.7%,10.3%,08/10/21,Trento,PAT,60-69,0.32%
70-79 anni,52872,49468,44707,44873,516,3020,1059,166,3404,93.6%,91.6%,6.4%,08/10/21,Trento,PAT,70-79,0.31%
80-89 anni,30673,30348,25486,28111,32,1613,592,2625,325,98.9%,97.0%,1.1%,08/10/21,Trento,PAT,80-89,8.56%
oltre 90 anni,8005,8240,7030,7562,7,408,263,532,-235,102.9%,99.7%,-2.9%,08/10/21,Trento,PAT,90+,6.65%
0-9 anni,54481,0,0,0,0,0,0,0,54481,0.0%,0.0%,100.0%,08/10/21,Bolzano,PAB,0-11,0.00%
10-19 anni,57132,24320,18762,18770,277,1047,4226,8,32812,42.6%,35.2%,57.4%,08/10/21,Bolzano,PAB,12-19,0.01%
20-29 anni,61426,45701,36021,36062,2148,2357,5134,41,15725,74.4%,66.0%,25.6%,08/10/21,Bolzano,PAB,20-29,0.07%
30-39 anni,62922,46588,36343,36433,2676,2445,5034,90,16334,74.0%,66.0%,26.0%,08/10/21,Bolzano,PAB,30-39,0.14%
40-49 anni,74006,56896,47008,47208,1801,3550,4337,200,17110,76.9%,71.0%,23.1%,08/10/21,Bolzano,PAB,40-49,0.27%
50-59 anni,84510,68302,57664,58155,1196,4816,4135,491,16208,80.8%,75.9%,19.2%,08/10/21,Bolzano,PAB,50-59,0.58%
60-69 anni,58814,50669,43264,43884,2110,3244,1431,620,8145,86.2%,83.7%,13.8%,08/10/21,Bolzano,PAB,60-69,1.05%
70-79 anni,46424,40551,35509,36227,1308,2204,812,718,5873,87.3%,85.6%,12.7%,08/10/21,Bolzano,PAB,70-79,1.55%
80-89 anni,27677,26009,23379,23767,497,1140,605,388,1668,94.0%,91.8%,6.0%,08/10/21,Bolzano,PAB,80-89,1.40%
oltre 90 anni,6323,5944,5164,5201,96,371,276,37,379,94.0%,89.6%,6.0%,08/10/21,Bolzano,PAB,90+,0.59%
0-9 anni,114169,0,0,0,0,0,0,0,114169,0.0%,0.0%,100.0%,08/10/21,Marche,MAR,0-11,0.00%
10-19 anni,137741,70121,60824,60828,28,2578,6687,4,67620,50.9%,46.1%,49.1%,08/10/21,Marche,MAR,12-19,0.00%
20-29 anni,145997,119290,104202,104255,354,5429,9252,53,26707,81.7%,75.4%,18.3%,08/10/21,Marche,MAR,20-29,0.04%
30-39 anni,163324,124559,107640,107777,488,5343,10951,137,38765,76.3%,69.6%,23.7%,08/10/21,Marche,MAR,30-39,0.08%
40-49 anni,218851,170255,151058,151371,1124,7475,10285,313,48596,77.8%,73.1%,22.2%,08/10/21,Marche,MAR,40-49,0.14%
50-59 anni,236599,197634,177984,178636,1887,8865,8246,652,38965,83.5%,80.0%,16.5%,08/10/21,Marche,MAR,50-59,0.28%
60-69 anni,194699,171583,145005,145984,17282,5988,2329,979,23116,88.1%,86.9%,11.9%,08/10/21,Marche,MAR,60-69,0.50%
70-79 anni,156000,145362,133015,134063,6630,4077,592,1048,10638,93.2%,92.8%,6.8%,08/10/21,Marche,MAR,70-79,0.67%
80-89 anni,108153,102679,95673,98180,590,2531,1378,2507,5474,94.9%,93.7%,5.1%,08/10/21,Marche,MAR,80-89,2.32%
oltre 90 anni,25873,25987,23955,24296,117,868,706,341,-114,100.4%,97.7%,-0.4%,08/10/21,Marche,MAR,90+,1.32%
0-9 anni,273053,0,0,0,0,0,0,0,273053,0.0%,0.0%,100.0%,08/10/21,Toscana,TOS,0-11,0.00%
10-19 anni,330958,200190,159557,159606,23,6641,33920,49,130768,60.5%,50.2%,39.5%,08/10/21,Toscana,TOS,12-19,0.01%
20-29 anni,338693,304694,256650,256959,399,11201,36135,309,33999,90.0%,79.3%,10.0%,08/10/21,Toscana,TOS,20-29,0.09%
30-39 anni,395198,337988,284204,284753,497,11518,41220,549,57210,85.5%,75.1%,14.5%,08/10/21,Toscana,TOS,30-39,0.14%
40-49 anni,540242,458337,397782,399127,706,16016,42488,1345,81905,84.8%,77.0%,15.2%,08/10/21,Toscana,TOS,40-49,0.25%
50-59 anni,590377,527114,470516,473130,1127,18729,34128,2614,63263,89.3%,83.5%,10.7%,08/10/21,Toscana,TOS,50-59,0.44%
60-69 anni,467270,425355,342115,345661,56667,10691,12336,3546,41915,91.0%,88.4%,9.0%,08/10/21,Toscana,TOS,60-69,0.76%
70-79 anni,406475,379879,340178,344507,19380,9691,6301,4329,26596,93.5%,91.9%,6.5%,08/10/21,Toscana,TOS,70-79,1.07%
80-89 anni,263150,260656,246379,248968,871,7495,3322,2589,2494,99.1%,97.8%,0.9%,08/10/21,Toscana,TOS,80-89,0.98%
oltre 90 anni,62917,66077,61061,62157,46,2021,1853,1096,-3160,105.0%,102.1%,-5.0%,08/10/21,Toscana,TOS,90+,1.74%
0-9 anni,463919,0,0,0,0,0,0,0,463919,0.0%,0.0%,100.0%,08/10/21,Lazio,LAZ,0-11,0.00%
10-19 anni,540535,298517,262432,262466,2770,7389,25892,34,242018,55.2%,50.4%,44.8%,08/10/21,Lazio,LAZ,12-19,0.01%
20-29 anni,558855,484362,392330,392549,41045,14906,35862,219,74493,86.7%,80.3%,13.3%,08/10/21,Lazio,LAZ,20-29,0.04%
30-39 anni,665641,550719,445955,446529,51982,16292,35916,574,114922,82.7%,77.3%,17.3%,08/10/21,Lazio,LAZ,30-39,0.09%
40-49 anni,879906,738709,596703,598003,78272,23190,39244,1300,141197,84.0%,79.5%,16.0%,08/10/21,Lazio,LAZ,40-49,0.15%
50-59 anni,940470,839323,688825,691225,88314,27160,32624,2400,101147,89.2%,85.8%,10.8%,08/10/21,Lazio,LAZ,50-59,0.26%
60-69 anni,707706,658214,597438,600383,21904,19694,16233,2945,49492,93.0%,90.7%,7.0%,08/10/21,Lazio,LAZ,60-69,0.42%
70-79 anni,551477,521989,492637,495641,5698,12166,8484,3004,29488,94.7%,93.1%,5.3%,08/10/21,Lazio,LAZ,70-79,0.54%
80-89 anni,338530,332048,300470,318936,295,6346,6471,18466,6482,98.1%,96.2%,1.9%,08/10/21,Lazio,LAZ,80-89,5.45%
oltre 90 anni,73757,74143,66271,69547,116,1801,2679,3276,-386,100.5%,96.9%,-0.5%,08/10/21,Lazio,LAZ,90+,4.44%
0-9 anni,64317,0,0,0,0,0,0,0,64317,0.0%,0.0%,100.0%,08/10/21,Umbria,UMB,0-11,0.00%
10-19 anni,78462,43908,37130,37144,15,1026,5723,14,34554,56.0%,48.7%,44.0%,08/10/21,Umbria,UMB,12-19,0.02%
20-29 anni,81178,65688,57060,57138,279,2109,6162,78,15490,80.9%,73.3%,19.1%,08/10/21,Umbria,UMB,20-29,0.10%
30-39 anni,95565,74956,65538,65686,180,2618,6472,148,20609,78.4%,71.7%,21.6%,08/10/21,Umbria,UMB,30-39,0.15%
40-49 anni,124859,102535,91394,91747,102,3927,6759,353,22324,82.1%,76.7%,17.9%,08/10/21,Umbria,UMB,40-49,0.28%
50-59 anni,135406,117900,107737,108504,82,4123,5191,767,17506,87.1%,83.2%,12.9%,08/10/21,Umbria,UMB,50-59,0.57%
60-69 anni,111650,102012,78757,79875,17657,2296,2184,1118,9638,91.4%,89.4%,8.6%,08/10/21,Umbria,UMB,60-69,1.00%
70-79 anni,94797,90380,83055,84459,2448,1897,1576,1404,4417,95.3%,93.7%,4.7%,08/10/21,Umbria,UMB,70-79,1.48%
80-89 anni,63188,62546,53697,60173,41,1594,738,6476,642,99.0%,97.8%,1.0%,08/10/21,Umbria,UMB,80-89,10.25%
oltre 90 anni,15591,16610,14993,15716,10,430,454,723,-1019,106.5%,103.6%,-6.5%,08/10/21,Umbria,UMB,90+,4.64%
0-9 anni,97834,0,0,0,0,0,0,0,97834,0.0%,0.0%,100.0%,08/10/21,Abruzzo,ABR,0-11,0.00%
10-19 anni,115344,67104,58121,58123,92,1740,7149,2,48240,58.2%,52.0%,41.8%,08/10/21,Abruzzo,ABR,12-19,0.00%
20-29 anni,128330,108615,95345,95364,1348,3666,8237,19,19715,84.6%,78.2%,15.4%,08/10/21,Abruzzo,ABR,20-29,0.01%
30-39 anni,148176,115480,99917,99961,2250,3858,9411,44,32696,77.9%,71.6%,22.1%,08/10/21,Abruzzo,ABR,30-39,0.03%
40-49 anni,185634,149753,130738,130850,4843,5174,8886,112,35881,80.7%,75.9%,19.3%,08/10/21,Abruzzo,ABR,40-49,0.06%
50-59 anni,204504,175921,154505,154755,7320,6091,7755,250,28583,86.0%,82.2%,14.0%,08/10/21,Abruzzo,ABR,50-59,0.12%
60-69 anni,168878,152645,138003,138363,5644,4783,3855,360,16233,90.4%,88.1%,9.6%,08/10/21,Abruzzo,ABR,60-69,0.21%
70-79 anni,131536,123706,116245,116617,2456,3125,1508,372,7830,94.0%,92.9%,6.0%,08/10/21,Abruzzo,ABR,70-79,0.28%
80-89 anni,84626,78968,75605,76019,181,1829,939,414,5658,93.3%,92.2%,6.7%,08/10/21,Abruzzo,ABR,80-89,0.49%
oltre 90 anni,20394,19322,18144,18297,52,556,417,153,1072,94.7%,92.7%,5.3%,08/10/21,Abruzzo,ABR,90+,0.75%
0-9 anni,20523,0,0,0,0,0,0,0,20523,0.0%,0.0%,100.0%,08/10/21,Molise,MOL,0-11,0.00%
10-19 anni,25234,15681,13716,13724,18,324,1615,8,9553,62.1%,55.7%,37.9%,08/10/21,Molise,MOL,12-19,0.03%
20-29 anni,31281,25038,20874,20914,1097,671,2356,40,6243,80.0%,72.5%,20.0%,08/10/21,Molise,MOL,20-29,0.13%
30-39 anni,33973,26331,21706,21746,1094,826,2665,40,7642,77.5%,69.7%,22.5%,08/10/21,Molise,MOL,30-39,0.12%
40-49 anni,41036,34625,30634,30747,611,1102,2165,113,6411,84.4%,79.1%,15.6%,08/10/21,Molise,MOL,40-49,0.28%
50-59 anni,46916,43052,37642,37919,1136,1754,2243,277,3864,91.8%,87.0%,8.2%,08/10/21,Molise,MOL,50-59,0.59%
60-69 anni,40784,38227,34385,34847,1481,1290,609,462,2557,93.7%,92.2%,6.3%,08/10/21,Molise,MOL,60-69,1.13%
70-79 anni,30617,29209,27282,27750,539,767,153,468,1408,95.4%,94.9%,4.6%,08/10/21,Molise,MOL,70-79,1.53%
80-89 anni,20753,19792,14618,18815,27,533,417,4197,961,95.4%,93.4%,4.6%,08/10/21,Molise,MOL,80-89,20.22%
oltre 90 anni,5430,5456,4125,4978,3,254,221,853,-26,100.5%,96.4%,-0.5%,08/10/21,Molise,MOL,90+,15.71%
0-9 anni,498552,0,0,0,0,0,0,0,498552,0.0%,0.0%,100.0%,08/10/21,Campania,CAM,0-11,0.00%
10-19 anni,616169,339344,275279,275315,20761,9371,33897,36,276825,55.1%,49.6%,44.9%,08/10/21,Campania,CAM,12-19,0.01%
20-29 anni,685126,539216,448604,449572,23733,21408,44503,968,145910,78.7%,72.2%,21.3%,08/10/21,Campania,CAM,20-29,0.14%
30-39 anni,706752,541522,446032,447881,24301,21560,47780,1849,165230,76.6%,69.9%,23.4%,08/10/21,Campania,CAM,30-39,0.26%
40-49 anni,819391,661197,571869,574269,18016,26450,42462,2400,158194,80.7%,75.5%,19.3%,08/10/21,Campania,CAM,40-49,0.29%
50-59 anni,871123,750036,665939,669570,12342,36793,31331,3631,121087,86.1%,82.5%,13.9%,08/10/21,Campania,CAM,50-59,0.42%
60-69 anni,681008,614365,546930,551566,13863,25998,22938,4636,66643,90.2%,86.8%,9.8%,08/10/21,Campania,CAM,60-69,0.68%
70-79 anni,491191,451723,418349,420866,2534,15687,12636,2517,39468,92.0%,89.4%,8.0%,08/10/21,Campania,CAM,70-79,0.51%
80-89 anni,258456,234334,203316,223061,96,6042,5135,19745,24122,90.7%,88.7%,9.3%,08/10/21,Campania,CAM,80-89,7.64%
oltre 90 anni,51991,44915,39685,42191,6,922,1796,2506,7076,86.4%,82.9%,13.6%,08/10/21,Campania,CAM,90+,4.82%
0-9 anni,307917,0,0,0,0,0,0,0,307917,0.0%,0.0%,100.0%,08/10/21,Puglia,PUG,0-11,0.00%
10-19 anni,389429,244949,213248,213287,907,7545,23210,39,144480,62.9%,56.9%,37.1%,08/10/21,Puglia,PUG,12-19,0.01%
20-29 anni,435687,355335,306701,306940,4689,13904,29802,239,80352,81.6%,74.7%,18.4%,08/10/21,Puglia,PUG,20-29,0.05%
30-39 anni,453251,369064,316665,317085,6526,14573,30880,420,84187,81.4%,74.6%,18.6%,08/10/21,Puglia,PUG,30-39,0.09%
40-49 anni,570896,489167,419815,420841,21726,19210,27390,1026,81729,85.7%,80.9%,14.3%,08/10/21,Puglia,PUG,40-49,0.18%
50-59 anni,607181,551700,470412,472347,32898,23404,23051,1935,55481,90.9%,87.1%,9.1%,08/10/21,Puglia,PUG,50-59,0.32%
60-69 anni,494337,469438,409656,412076,26483,18307,12572,2420,24899,95.0%,92.4%,5.0%,08/10/21,Puglia,PUG,60-69,0.49%
70-79 anni,395276,383835,348339,350599,13595,11502,8139,2260,11441,97.1%,95.0%,2.9%,08/10/21,Puglia,PUG,70-79,0.57%
80-89 anni,224826,219872,208679,209770,136,4899,5067,1091,4954,97.8%,95.5%,2.2%,08/10/21,Puglia,PUG,80-89,0.49%
oltre 90 anni,48131,48888,45646,45857,5,1096,1930,211,-757,101.6%,97.6%,-1.6%,08/10/21,Puglia,PUG,90+,0.44%
0-9 anni,39386,0,0,0,0,0,0,0,39386,0.0%,0.0%,100.0%,08/10/21,Basilicata,BAS,0-11,0.00%
10-19 anni,50240,30967,25891,25893,1577,705,2792,2,19273,61.6%,56.1%,38.4%,08/10/21,Basilicata,BAS,12-19,0.00%
20-29 anni,59650,46207,40633,40645,851,1367,3344,12,13443,77.5%,71.9%,22.5%,08/10/21,Basilicata,BAS,20-29,0.02%
30-39 anni,64519,48026,42516,42540,585,1260,3641,24,16493,74.4%,68.8%,25.6%,08/10/21,Basilicata,BAS,30-39,0.04%
40-49 anni,76260,62334,54660,54706,2831,1663,3134,46,13926,81.7%,77.6%,18.3%,08/10/21,Basilicata,BAS,40-49,0.06%
50-59 anni,87305,76812,68404,68490,3012,2157,3153,86,10493,88.0%,84.4%,12.0%,08/10/21,Basilicata,BAS,50-59,0.10%
60-69 anni,73674,68476,62521,62656,2087,1479,2254,135,5198,92.9%,89.9%,7.1%,08/10/21,Basilicata,BAS,60-69,0.18%
70-79 anni,52557,50178,47932,48039,134,951,1054,107,2379,95.5%,93.5%,4.5%,08/10/21,Basilicata,BAS,70-79,0.20%
80-89 anni,35786,33404,31819,32141,5,518,740,322,2382,93.3%,91.3%,6.7%,08/10/21,Basilicata,BAS,80-89,0.90%
oltre 90 anni,8202,8144,7645,7677,0,144,323,32,58,99.3%,95.4%,0.7%,08/10/21,Basilicata,BAS,90+,0.39%
0-9 anni,154451,0,0,0,0,0,0,0,154451,0.0%,0.0%,100.0%,08/10/21,Calabria,CAL,0-11,0.00%
10-19 anni,181488,94628,81152,81153,586,1391,11498,1,86860,52.1%,45.8%,47.9%,08/10/21,Calabria,CAL,12-19,0.00%
20-29 anni,208920,153922,132653,132669,5443,2944,12866,16,54998,73.7%,67.5%,26.3%,08/10/21,Calabria,CAL,20-29,0.01%
30-39 anni,232935,162453,137861,137888,7033,2786,14746,27,70482,69.7%,63.4%,30.3%,08/10/21,Calabria,CAL,30-39,0.01%
40-49 anni,261369,198353,166991,167068,14803,3323,13159,77,63016,75.9%,70.9%,24.1%,08/10/21,Calabria,CAL,40-49,0.03%
50-59 anni,284757,229956,199348,199534,15182,3661,11579,186,54801,80.8%,76.7%,19.2%,08/10/21,Calabria,CAL,50-59,0.07%
60-69 anni,243667,210994,195825,196100,6756,2647,5491,275,32673,86.6%,84.3%,13.4%,08/10/21,Calabria,CAL,60-69,0.11%
70-79 anni,177666,158883,152496,152792,2183,1466,2442,296,18783,89.4%,88.1%,10.6%,08/10/21,Calabria,CAL,70-79,0.17%
80-89 anni,108240,93000,89762,90130,75,674,2121,368,15240,85.9%,84.0%,14.1%,08/10/21,Calabria,CAL,80-89,0.34%
oltre 90 anni,24235,20144,19028,19120,17,138,869,92,4091,83.1%,79.5%,16.9%,08/10/21,Calabria,CAL,90+,0.38%
0-9 anni,411065,0,0,0,0,0,0,0,411065,0.0%,0.0%,100.0%,08/10/21,Sicilia,SIC,0-11,0.00%
10-19 anni,491263,253252,208568,208578,9043,5175,30456,10,238011,51.6%,45.4%,48.4%,08/10/21,Sicilia,SIC,12-19,0.00%
20-29 anni,551159,405534,340921,341024,15827,10922,37761,103,145625,73.6%,66.7%,26.4%,08/10/21,Sicilia,SIC,20-29,0.02%
30-39 anni,581042,419430,352152,352304,15007,10250,41869,152,161612,72.2%,65.0%,27.8%,08/10/21,Sicilia,SIC,30-39,0.03%
40-49 anni,684564,525545,449692,450058,22550,12830,40107,366,159019,76.8%,70.9%,23.2%,08/10/21,Sicilia,SIC,40-49,0.05%
50-59 anni,732410,603972,530355,531055,21675,15546,35696,700,128438,82.5%,77.6%,17.5%,08/10/21,Sicilia,SIC,50-59,0.10%
60-69 anni,608346,525208,476934,478068,15252,11432,20456,1134,83138,86.3%,83.0%,13.7%,08/10/21,Sicilia,SIC,60-69,0.19%
70-79 anni,460198,407762,382392,383378,4896,6797,12691,986,52436,88.6%,85.8%,11.4%,08/10/21,Sicilia,SIC,70-79,0.21%
80-89 anni,265138,232471,220292,222245,110,3628,6488,1953,32667,87.7%,85.2%,12.3%,08/10/21,Sicilia,SIC,80-89,0.74%
oltre 90 anni,55691,48701,45330,45576,16,959,2150,246,6990,87.4%,83.6%,12.6%,08/10/21,Sicilia,SIC,90+,0.44%
0-9 anni,105570,0,0,0,0,0,0,0,105570,0.0%,0.0%,100.0%,08/10/21,Sardegna,SAR,0-11,0.00%
10-19 anni,134368,85068,75272,75275,3,1413,8377,3,49300,63.3%,57.1%,36.7%,08/10/21,Sardegna,SAR,12-19,0.00%
20-29 anni,149270,121394,109005,109039,94,3075,9186,34,27876,81.3%,75.2%,18.7%,08/10/21,Sardegna,SAR,20-29,0.02%
30-39 anni,180864,141683,125967,126081,286,3308,12008,114,39181,78.3%,71.7%,21.7%,08/10/21,Sardegna,SAR,30-39,0.06%
40-49 anni,244621,199863,181269,181555,526,4749,13033,286,44758,81.7%,76.4%,18.3%,08/10/21,Sardegna,SAR,40-49,0.12%
50-59 anni,266104,230498,211646,212142,835,5473,12048,496,35606,86.6%,82.1%,13.4%,08/10/21,Sardegna,SAR,50-59,0.19%
60-69 anni,225334,205236,179967,180597,13921,4188,6530,630,20098,91.1%,88.2%,8.9%,08/10/21,Sardegna,SAR,60-69,0.28%
70-79 anni,172099,160360,149013,149576,5862,2560,2362,563,11739,93.2%,91.8%,6.8%,08/10/21,Sardegna,SAR,70-79,0.33%
80-89 anni,97957,92235,88076,88422,161,1326,2326,346,5722,94.2%,91.8%,5.8%,08/10/21,Sardegna,SAR,80-89,0.35%
oltre 90 anni,22038,20647,19111,19192,47,420,988,81,1391,93.7%,89.2%,6.3%,08/10/21,Sardegna,SAR,90+,0.37%
